うかしぇゔぃち	Łukasiewicz	人名	
えんぶらん	Herbrand	人名	
きりさめまりさ	霧雨魔理沙	人名	
くりぷき	Kripke	人名	
げーでる	Gödel	人名	
すこーれむ	Skolem	人名	
すまりやん	Smullyan	人名	
バーンスタイン	Bernstein	人名	
はくれいれいむ	博麗霊夢	人名	 
フーリエ	Fourier	人名	
べじえ	Bezier	人名	
ゆあせるふ	結愛せるふ	人名	
れーふ	Löb	人名	
まりさ	魔理沙	名	
いんぼうろんじゃ	陰謀論者	名詞	
いんむ	淫夢	名詞	
えんぶらんこうぞう	Herbrand構造	名詞	
おげんしょう	汚言症	名詞	
かたずけ	型付け	名詞	
かたなし	型無し	名詞	
かたなしさんじゅつしき	型無し算術式	名詞	
かりーはわーどたいおう	Curry-Howard対応	名詞	
かりーはわーどどうけいたいおう	Curry-Howard同型対応	名詞	
かんとうひょうじゅんけい	冠頭標準形	名詞	
くうしゅうごう	空集合	名詞	
くりぷきふれーむ	Kripkeフレーム	名詞	
くりぷきもでる	Kripkeモデル	名詞	
げんしさいき	原始再帰	名詞	
こうし	行使	名詞	
こうじ	高次	名詞	
こうじげん	高次元	名詞	
こうしん	恒真	名詞	
さんじゅつ	算術	名詞	
すこーれむひょうじゅんけい	Skolem標準形	名詞	
そけつごう	疎結合	名詞	
そんざいかんとうひょうじゅんけい	存在冠頭標準形	名詞	
たげんうちゅう	多元宇宙	名詞	
たこういかのうせい	他行為可能性	名詞	
たこういせい	他行為性	名詞	
たんじゅんかたつきらむだけいさん	単純型付きλ計算	名詞	
ちゃーち	Church	名詞	
ちゃーちすう	Church数	名詞	
ひだとう	非妥当	名詞	
ふちかんすう	付値関数	名詞	
ほしゅうごう	補集合	名詞	
らむだけいさん	λ計算	名詞	
りょうかし	量化子	名詞	
ごうよくいもん	剛欲異聞	固有名詞	
しおがまいこがまい	潮が舞い子が舞い	固有名詞	
ちきれいでん	智霊奇伝	固有名詞	
バーンスタインかんすう	Bernstein関数	固有名詞	
ベジエきょくせん	Bezier曲線	固有名詞	
まーてぃんれーふかたりろん	Martin-Löf型理論	固有名詞	
らよかんすう	ラヨ関数	固有名詞	
ちれいでん	地霊殿	地名	 
すまりやん	Smullyan	短縮よみ	
AND	∧	記号	
EQ	↔	記号	
INVALID	⊭	記号	
NOT	¬	記号	
OR	∨	記号	
TO	→	記号	
VALID	⊨	記号	
かつ	∧	記号	
ぎ	⊥	記号	
しん	⊤	記号	
だとう	⊨	記号	
とーとろじー	⊤	記号	
ひだとう	⊭	記号	
ひてい	¬	記号	
または	∨	記号	
むじゅん	⊥	記号	
きたー	ｷﾀ―――(ﾟ∀ﾟ)―――― !!	顔文字	
