AND	∧	記号	
EQ	↔	記号	
INVALID	⊭	記号	
NOT	¬	記号	
OR	∨	記号	
TO	→	記号	
VALID	⊨	記号	
ぎ	⊥	記号	
しん	⊤	記号	
だとう	⊨	記号	
とーとろじー	⊤	記号	
ひだとう	⊭	記号	
ひだとう	非妥当	名詞	
ひてい	¬	記号	
または	∨	記号	
むじゅん	⊥	記号	
りょうかし	量化子	名詞	
こうしん	恒真	名詞	
そんざいかんとうひょうじゅんけい	存在冠頭標準形	名詞	
かんとうひょうじゅんけい	冠頭標準形	名詞	
えんぶらんこうぞう	Herbrand構造	名詞	
すこーれむひょうじゅんけい	Skolem標準形	名詞	
エンブラン	Herbrand	人名	
スコーレム	Skolem	人名	
ゲーデル	Gödel	人名	
ふちかんすう	付値関数	名詞	
クリプキ	Kripke	人名	
クリプキモデル	Kripkeモデル	名詞	
クリプキフレーム	Kripkeフレーム	名詞	
スマリヤン	Smullyan	短縮よみ	
えんぶらん	Herbrand	人名	
すこーれむ	Skolem	人名	
げーでる	Gödel	人名	
くりぷき	Kripke	人名	
くりぷきもでる	Kripkeモデル	名詞	
くりぷきふれーむ	Kripkeフレーム	名詞	
すまりやん	Smullyan	人名	
ウカシェヴィチ	Łukasiewicz	人名	
かつ	∧	記号	
すまりやん	Smullyan	短縮よみ	
かたなし	型無し	名詞	
かたなしさんじゅつしき	型無し算術式	名詞	
さんじゅつ	算術	名詞	
げんしさいき	原始再帰	名詞	
ほしゅうごう	補集合	名詞	
くうしゅうごう	空集合	名詞	
ちゃーち	Church	名詞	
ちゃーちすう	Church数	名詞	
かたずけ	型付け	名詞	
らむだけいさん	λ計算	名詞	
かりーはわーどたいおう	Curry-Howard対応	名詞	
かりーはわーどどうけいたいおう	Curry-Howard同型対応	名詞	
たんじゅんかたつきらむだけいさん	単純型付きλ計算	名詞	
れーふ	Löb	人名	
まーてぃんれーふかたりろん	Martin-Löf型理論	固有名詞	
うかしぇゔぃち	Łukasiewicz	人名	
そけつごう	疎結合	名詞	
こうじげん	高次元	名詞	
こうじ	高次	名詞	
らよかんすう	ラヨ関数	固有名詞	
